#########
#oooXooo#
#o#####o#
#Ooo#ooO#
###ooo###
#ooooooo#
#o## ##o#
 o# o #o 
#o## ##o#
#oooMooo#
#o#####o#
#oooXooo#
#########