#########
#ooooooo#
#o#####o#
#Ooo#ooO#
###o#o###
#oooXooo#
#o#####o#
 o#   #o 
#o#####o#
#oooMooo#
#o#####o#
#ooooooo#
#########